0000000000011111100000000000111110000000000000000000000111111110000000
00000000000000001111111000001111100000111111000000000000000000000
11111111111111111111111111111111111111111111111111111111111111111
11111111111111111111111111111111111111111111111111111111111111111
00000000111111110000011111111001100000000111100000000000000000000
0000000001111111000000000011111000000001111110000000000000000000010
11111111111111111111111111111111111111111111111111111111111111111
11111111111111111111111111111111111111111111111111111111111111111
00000000000000000000000011111000000000000000000000000000000000000
00000000000000000000000011111000000000000000000000000000000000000
00000000000000000000000011111000000000000000000000000000000000000
111111111111111111111111111111111111111111111111111111111111111110
11111111111111111111111111111111111111111111111111111111111111111
00000000000000000000000011111000000000000000000000000000000000000
00000000000000000000000011111000000000000000000000000000000000000
00000000000000000000000011111000000000000000000000000000000000000
11111111111111111111111111111111111111111111111111111111111111111000
11111111111111111111111111111111111111111111111111111111111111111
00000000000000000000000011111000000000000000000000000000000000000
00000000000000000000000011111000000000000000000000000000000000000
00000000000000000000000011111000000000000000000000000000000000000000
11111111111111111111111111111111111111111111111111111111111111111
11111111111111111111111111111111111111111111111111111111111111111
00000000000000000000000011111000000000000000000000000000000000000
00000000000000000000000011111000000000000000000000000000000000000
00000000000000000000000011111000000000000000000000000000000000000
11111111111111111111111111111111111111111111111111111111111111111
11111111111111111111111111111111111111111111111111111111111111111
00000